"filename", "language", "JavaScript", "JavaScript JSX", "CSS", "comment", "blank", "total"
"c:\Users\Lenovo\Desktop\aps\src\App.js", "JavaScript", 126, 0, 0, 0, 8, 134
"c:\Users\Lenovo\Desktop\aps\src\components\Error.js", "JavaScript", 15, 0, 0, 0, 2, 17
"c:\Users\Lenovo\Desktop\aps\src\components\Error.module.css", "CSS", 0, 0, 25, 0, 0, 25
"c:\Users\Lenovo\Desktop\aps\src\components\MainPage\MainPage.js", "JavaScript", 12, 0, 0, 0, 3, 15
"c:\Users\Lenovo\Desktop\aps\src\components\MainPage\MainPage.module.css", "CSS", 0, 0, 40, 0, 4, 44
"c:\Users\Lenovo\Desktop\aps\src\components\Notifications\Notifications.js", "JavaScript", 95, 0, 0, 0, 3, 98
"c:\Users\Lenovo\Desktop\aps\src\components\Notifications\Notifications.module.css", "CSS", 0, 0, 173, 0, 2, 175
"c:\Users\Lenovo\Desktop\aps\src\components\Profiles\CollegeProfile\AddDepartment.js", "JavaScript", 167, 0, 0, 0, 8, 175
"c:\Users\Lenovo\Desktop\aps\src\components\Profiles\CollegeProfile\AddDepartment.module.css", "CSS", 0, 0, 150, 0, 12, 162
"c:\Users\Lenovo\Desktop\aps\src\components\Profiles\CollegeProfile\CollegeProfile.js", "JavaScript", 257, 0, 0, 0, 2, 259
"c:\Users\Lenovo\Desktop\aps\src\components\Profiles\CollegeProfile\CollegeProfile.module.css", "CSS", 0, 0, 386, 0, 10, 396
"c:\Users\Lenovo\Desktop\aps\src\components\Profiles\DepartmentProfile\AddLevel.js", "JavaScript", 104, 0, 0, 1, 7, 112
"c:\Users\Lenovo\Desktop\aps\src\components\Profiles\DepartmentProfile\AddLevel.module.css", "CSS", 0, 0, 151, 0, 12, 163
"c:\Users\Lenovo\Desktop\aps\src\components\Profiles\DepartmentProfile\AddModule.js", "JavaScript", 174, 0, 0, 1, 6, 181
"c:\Users\Lenovo\Desktop\aps\src\components\Profiles\DepartmentProfile\AddModule.module.css", "CSS", 0, 0, 152, 0, 12, 164
"c:\Users\Lenovo\Desktop\aps\src\components\Profiles\DepartmentProfile\Classrooms\AddClass.js", "JavaScript", 180, 0, 0, 1, 12, 193
"c:\Users\Lenovo\Desktop\aps\src\components\Profiles\DepartmentProfile\Classrooms\AddClass.module.css", "CSS", 0, 0, 179, 0, 18, 197
"c:\Users\Lenovo\Desktop\aps\src\components\Profiles\DepartmentProfile\Classrooms\ClassroomsTable.js", "JavaScript", 158, 0, 0, 15, 11, 184
"c:\Users\Lenovo\Desktop\aps\src\components\Profiles\DepartmentProfile\Classrooms\ClassroomsTable.module.css", "CSS", 0, 0, 86, 0, 0, 86
"c:\Users\Lenovo\Desktop\aps\src\components\Profiles\DepartmentProfile\Classrooms\OptionsC.js", "JavaScript", 24, 0, 0, 1, 2, 27
"c:\Users\Lenovo\Desktop\aps\src\components\Profiles\DepartmentProfile\DepartmentProfile.js", "JavaScript", 277, 0, 0, 0, 3, 280
"c:\Users\Lenovo\Desktop\aps\src\components\Profiles\DepartmentProfile\DepartmentProfile.module.css", "CSS", 0, 0, 413, 0, 13, 426
"c:\Users\Lenovo\Desktop\aps\src\components\Profiles\DepartmentProfile\Exam\ExamComitte.js", "JavaScript", 67, 0, 0, 0, 0, 67
"c:\Users\Lenovo\Desktop\aps\src\components\Profiles\DepartmentProfile\LevelModule.js", "JavaScript", 156, 0, 0, 0, 2, 158
"c:\Users\Lenovo\Desktop\aps\src\components\Profiles\DepartmentProfile\LevelModules.module.css", "CSS", 0, 0, 132, 0, 0, 132
"c:\Users\Lenovo\Desktop\aps\src\components\Profiles\DepartmentProfile\Modules.js", "JavaScript", 41, 0, 0, 0, 5, 46
"c:\Users\Lenovo\Desktop\aps\src\components\Profiles\DepartmentProfile\Modules.module.css", "CSS", 0, 0, 49, 0, 1, 50
"c:\Users\Lenovo\Desktop\aps\src\components\Profiles\DepartmentProfile\Modules_s\AddNewModule.js", "JavaScript", 359, 0, 0, 1, 12, 372
"c:\Users\Lenovo\Desktop\aps\src\components\Profiles\DepartmentProfile\Modules_s\AddNewModule.module.css", "CSS", 0, 0, 262, 0, 13, 275
"c:\Users\Lenovo\Desktop\aps\src\components\Profiles\DepartmentProfile\Modules_s\EditModule.js", "JavaScript", 387, 0, 0, 31, 21, 439
"c:\Users\Lenovo\Desktop\aps\src\components\Profiles\DepartmentProfile\Modules_s\ModulesTable.js", "JavaScript", 130, 0, 0, 0, 10, 140
"c:\Users\Lenovo\Desktop\aps\src\components\Profiles\DepartmentProfile\Modules_s\ModulesTable.module.css", "CSS", 0, 0, 42, 0, 0, 42
"c:\Users\Lenovo\Desktop\aps\src\components\Profiles\DepartmentProfile\Modules_s\Options.js", "JavaScript", 18, 0, 0, 1, 0, 19
"c:\Users\Lenovo\Desktop\aps\src\components\Profiles\DepartmentProfile\Proffessor\AddProffessor.js", "JavaScript", 329, 0, 0, 1, 25, 355
"c:\Users\Lenovo\Desktop\aps\src\components\Profiles\DepartmentProfile\Proffessor\AddProffessor.module.css", "CSS", 0, 0, 262, 0, 14, 276
"c:\Users\Lenovo\Desktop\aps\src\components\Profiles\DepartmentProfile\Proffessor\PrefessorTable.js", "JavaScript", 155, 0, 0, 1, 14, 170
"c:\Users\Lenovo\Desktop\aps\src\components\Profiles\DepartmentProfile\Proffessor\ProfessorTable.module.css", "CSS", 0, 0, 42, 0, 0, 42
"c:\Users\Lenovo\Desktop\aps\src\components\Profiles\DepartmentProfile\Programs\AddProgram.js", "JavaScript", 355, 0, 0, 1, 10, 366
"c:\Users\Lenovo\Desktop\aps\src\components\Profiles\DepartmentProfile\Programs\AddProgram.module.css", "CSS", 0, 0, 262, 0, 13, 275
"c:\Users\Lenovo\Desktop\aps\src\components\Profiles\DepartmentProfile\Programs\AddSpeciality.js", "JavaScript", 193, 0, 0, 1, 12, 206
"c:\Users\Lenovo\Desktop\aps\src\components\Profiles\DepartmentProfile\Programs\AddSpeciality.module.css", "CSS", 0, 0, 111, 0, 4, 115
"c:\Users\Lenovo\Desktop\aps\src\components\Profiles\DepartmentProfile\Programs\BachelorFour.js", "JavaScript", 78, 0, 0, 13, 6, 97
"c:\Users\Lenovo\Desktop\aps\src\components\Profiles\DepartmentProfile\Programs\BachelorFour.module.css", "CSS", 0, 0, 128, 0, 2, 130
"c:\Users\Lenovo\Desktop\aps\src\components\Profiles\DepartmentProfile\Programs\DisplayLevels.js", "JavaScript", 35, 0, 0, 0, 0, 35
"c:\Users\Lenovo\Desktop\aps\src\components\Profiles\DepartmentProfile\Programs\PreviewBachelor.js", "JavaScript", 79, 0, 0, 0, 1, 80
"c:\Users\Lenovo\Desktop\aps\src\components\Profiles\DepartmentProfile\Programs\PreviewBachelor.module.css", "CSS", 0, 0, 109, 0, 3, 112
"c:\Users\Lenovo\Desktop\aps\src\components\Profiles\DepartmentProfile\Programs\ProgramManage.js", "JavaScript", 53, 0, 0, 0, 3, 56
"c:\Users\Lenovo\Desktop\aps\src\components\Profiles\DepartmentProfile\Programs\ProgramManage.module.css", "CSS", 0, 0, 106, 0, 9, 115
"c:\Users\Lenovo\Desktop\aps\src\components\Profiles\DepartmentProfile\Programs\ProgramModules\ProgramModulesTable.js", "JavaScript", 130, 0, 0, 0, 10, 140
"c:\Users\Lenovo\Desktop\aps\src\components\Profiles\DepartmentProfile\Programs\ProgramModules\ProgramModulesTable.module.css", "CSS", 0, 0, 42, 0, 0, 42
"c:\Users\Lenovo\Desktop\aps\src\components\Profiles\DepartmentProfile\Programs\Speciality.js", "JavaScript", 121, 0, 0, 1, 5, 127
"c:\Users\Lenovo\Desktop\aps\src\components\Profiles\DepartmentProfile\Programs\Speciality.module.css", "CSS", 0, 0, 53, 0, 2, 55
"c:\Users\Lenovo\Desktop\aps\src\components\Profiles\DepartmentProfile\Programs\add_program_module\AddBook.js", "JavaScript", 95, 0, 0, 7, 3, 105
"c:\Users\Lenovo\Desktop\aps\src\components\Profiles\DepartmentProfile\Programs\add_program_module\AddProgramModule.js", "JavaScript", 217, 0, 0, 1, 3, 221
"c:\Users\Lenovo\Desktop\aps\src\components\Profiles\DepartmentProfile\Programs\add_program_module\AddProgramModule.module.css", "CSS", 0, 0, 183, 0, 9, 192
"c:\Users\Lenovo\Desktop\aps\src\components\Profiles\DepartmentProfile\Programs\add_program_module\AddUnstructHours.js", "JavaScript", 68, 0, 0, 0, 4, 72
"c:\Users\Lenovo\Desktop\aps\src\components\Profiles\DepartmentProfile\Programs\add_program_module\ModuleAssesment.js", "JavaScript", 202, 0, 0, 1, 5, 208
"c:\Users\Lenovo\Desktop\aps\src\components\Profiles\DepartmentProfile\Programs\add_program_module\ModuleInfo.js", "JavaScript", 352, 0, 0, 2, 5, 359
"c:\Users\Lenovo\Desktop\aps\src\components\Profiles\DepartmentProfile\Programs\add_program_module\ModuleInfo.module.css", "CSS", 0, 0, 202, 0, 17, 219
"c:\Users\Lenovo\Desktop\aps\src\components\Profiles\DepartmentProfile\Programs\add_program_module\ModuleLab.js", "JavaScript", 62, 0, 0, 0, 5, 67
"c:\Users\Lenovo\Desktop\aps\src\components\Profiles\DepartmentProfile\Programs\add_program_module\ModuleSources.js", "JavaScript", 68, 0, 0, 0, 3, 71
"c:\Users\Lenovo\Desktop\aps\src\components\Profiles\DepartmentProfile\Programs\add_program_module\ModuleSrtructuredHours.js", "JavaScript", 174, 0, 0, 2, 6, 182
"c:\Users\Lenovo\Desktop\aps\src\components\Profiles\DepartmentProfile\Programs\add_program_module\ModuleStructuredHours.module.css", "CSS", 0, 0, 110, 0, 3, 113
"c:\Users\Lenovo\Desktop\aps\src\components\Profiles\DepartmentProfile\Programs\add_program_module\ModuleTheory.js", "JavaScript", 65, 0, 0, 0, 4, 69
"c:\Users\Lenovo\Desktop\aps\src\components\Profiles\DepartmentProfile\Programs\add_program_module\ModuleUnstructHours.js", "JavaScript", 166, 0, 0, 2, 5, 173
"c:\Users\Lenovo\Desktop\aps\src\components\Profiles\UniversityProfile\AboutComponent.js", "JavaScript", 39, 0, 0, 0, 0, 39
"c:\Users\Lenovo\Desktop\aps\src\components\Profiles\UniversityProfile\AboutComponent.module.css", "CSS", 0, 0, 58, 0, 1, 59
"c:\Users\Lenovo\Desktop\aps\src\components\Profiles\UniversityProfile\AddCollege.js", "JavaScript", 171, 0, 0, 0, 9, 180
"c:\Users\Lenovo\Desktop\aps\src\components\Profiles\UniversityProfile\AddCollege.module.css", "CSS", 0, 0, 150, 0, 12, 162
"c:\Users\Lenovo\Desktop\aps\src\components\Profiles\UniversityProfile\CustomInput.js", "JavaScript", 58, 0, 0, 0, 0, 58
"c:\Users\Lenovo\Desktop\aps\src\components\Profiles\UniversityProfile\CustomInput.module.css", "CSS", 0, 0, 73, 0, 2, 75
"c:\Users\Lenovo\Desktop\aps\src\components\Profiles\UniversityProfile\EditProfile.js", "JavaScript", 278, 0, 0, 1, 3, 282
"c:\Users\Lenovo\Desktop\aps\src\components\Profiles\UniversityProfile\EditProfile.module.css", "CSS", 0, 0, 73, 0, 3, 76
"c:\Users\Lenovo\Desktop\aps\src\components\Profiles\UniversityProfile\UniversityProfile.js", "JavaScript", 257, 0, 0, 0, 2, 259
"c:\Users\Lenovo\Desktop\aps\src\components\Profiles\UniversityProfile\UniversityProfile.module.css", "CSS", 0, 0, 384, 0, 9, 393
"c:\Users\Lenovo\Desktop\aps\src\components\Profiles\UniversityProfile\preview.js", "JavaScript", 102, 0, 0, 0, 6, 108
"c:\Users\Lenovo\Desktop\aps\src\components\Root.js", "JavaScript", 27, 0, 0, 0, 1, 28
"c:\Users\Lenovo\Desktop\aps\src\components\Root.module.css", "CSS", 0, 0, 45, 0, 0, 45
"c:\Users\Lenovo\Desktop\aps\src\components\UI\BaiscSwitch.js", "JavaScript", 45, 0, 0, 0, 2, 47
"c:\Users\Lenovo\Desktop\aps\src\components\UI\ErrorBox\ErrorBox.js", "JavaScript", 27, 0, 0, 0, 0, 27
"c:\Users\Lenovo\Desktop\aps\src\components\UI\ErrorBox\ErrorBox.module.css", "CSS", 0, 0, 43, 0, 8, 51
"c:\Users\Lenovo\Desktop\aps\src\components\UI\Loader\Button\Button.js", "JavaScript", 10, 0, 0, 0, 0, 10
"c:\Users\Lenovo\Desktop\aps\src\components\UI\Loader\Button\Button.module.css", "CSS", 0, 0, 13, 0, 0, 13
"c:\Users\Lenovo\Desktop\aps\src\components\UI\Loader\Loader.js", "JavaScript", 13, 0, 0, 0, 2, 15
"c:\Users\Lenovo\Desktop\aps\src\components\UI\Loader\Loader.module.css", "CSS", 0, 0, 40, 0, 2, 42
"c:\Users\Lenovo\Desktop\aps\src\components\UI\Loader\Myloader.js", "JavaScript", 13, 0, 0, 0, 2, 15
"c:\Users\Lenovo\Desktop\aps\src\components\UI\Loader\PlaceHolderLoader.js", "JavaScript", 15, 0, 0, 0, 0, 15
"c:\Users\Lenovo\Desktop\aps\src\components\UI\Loader\PlaceHolderLoader.module.css", "CSS", 0, 0, 60, 0, 1, 61
"c:\Users\Lenovo\Desktop\aps\src\components\UI\Loader\myLoader.module.css", "CSS", 0, 0, 39, 0, 3, 42
"c:\Users\Lenovo\Desktop\aps\src\components\UI\Menu.js", "JavaScript", 45, 0, 0, 0, 2, 47
"c:\Users\Lenovo\Desktop\aps\src\components\UI\progressBar\LinearProgressWithLabel.js", "JavaScript", 33, 0, 0, 4, 5, 42
"c:\Users\Lenovo\Desktop\aps\src\components\login\Login.js", "JavaScript", 179, 0, 0, 0, 14, 193
"c:\Users\Lenovo\Desktop\aps\src\components\login\Login.module.css", "CSS", 0, 0, 197, 0, 9, 206
"c:\Users\Lenovo\Desktop\aps\src\components\navbar\Navbar.js", "JavaScript", 243, 0, 0, 2, 7, 252
"c:\Users\Lenovo\Desktop\aps\src\components\navbar\Navbar.module.css", "CSS", 0, 0, 207, 8, 7, 222
"c:\Users\Lenovo\Desktop\aps\src\components\universityAccounts\AddUniversity.js", "JavaScript", 163, 0, 0, 1, 8, 172
"c:\Users\Lenovo\Desktop\aps\src\components\universityAccounts\AddUniversity.module.css", "CSS", 0, 0, 150, 0, 12, 162
"c:\Users\Lenovo\Desktop\aps\src\components\universityAccounts\UniversityAccounts.js", "JavaScript", 180, 0, 0, 0, 6, 186
"c:\Users\Lenovo\Desktop\aps\src\components\universityAccounts\UniversityAccounts.module.css", "CSS", 0, 0, 171, 0, 2, 173
"c:\Users\Lenovo\Desktop\aps\src\hooks\useFetch.jsx", "JavaScript JSX", 0, 28, 0, 0, 1, 29
"c:\Users\Lenovo\Desktop\aps\src\hooks\useOneFetch.jsx", "JavaScript JSX", 0, 25, 0, 0, 0, 25
"c:\Users\Lenovo\Desktop\aps\src\hooks\usePaginationFetch.jsx", "JavaScript JSX", 0, 50, 0, 1, 4, 55
"c:\Users\Lenovo\Desktop\aps\src\hooks\useStudents.jsx", "JavaScript JSX", 0, 24, 0, 0, 1, 25
"c:\Users\Lenovo\Desktop\aps\src\hooks\useSubjects.jsx", "JavaScript JSX", 0, 39, 0, 4, 6, 49
"c:\Users\Lenovo\Desktop\aps\src\index.css", "CSS", 0, 0, 21, 0, 1, 22
"c:\Users\Lenovo\Desktop\aps\src\index.js", "JavaScript", 8, 0, 0, 0, 2, 10
"c:\Users\Lenovo\Desktop\aps\src\store\auth-slice.js", "JavaScript", 164, 0, 0, 0, 1, 165
"c:\Users\Lenovo\Desktop\aps\src\store\error-slice.js", "JavaScript", 24, 0, 0, 0, 0, 24
"c:\Users\Lenovo\Desktop\aps\src\store\fire.jsx", "JavaScript JSX", 0, 168, 0, 1, 5, 174
"c:\Users\Lenovo\Desktop\aps\src\store\getandset.js", "JavaScript", 185, 0, 0, 0, 9, 194
"c:\Users\Lenovo\Desktop\aps\src\store\index.js", "JavaScript", 9, 0, 0, 0, 0, 9
"c:\Users\Lenovo\Desktop\aps\src\store\notify-slice.js", "JavaScript", 16, 0, 0, 0, 0, 16
"c:\Users\Lenovo\Desktop\aps\src\store\profile-slice.js", "JavaScript", 43, 0, 0, 0, 1, 44
"Total", "-", 8091, 334, 5574, 107, 590, 14696