"filename", "language", "JavaScript", "JavaScript JSX", "CSS", "comment", "blank", "total"
"c:\Users\Lenovo\Desktop\aps\src\App.js", "JavaScript", 10, 0, 0, 0, 0, 10
"c:\Users\Lenovo\Desktop\aps\src\components\Notifications\Notifications.js", "JavaScript", 9, 0, 0, 0, 5, 14
"c:\Users\Lenovo\Desktop\aps\src\components\Profiles\DepartmentProfile\DepartmentProfile.js", "JavaScript", 1, 0, 0, 0, 0, 1
"c:\Users\Lenovo\Desktop\aps\src\components\Profiles\DepartmentProfile\Exam\AddExam.js", "JavaScript", 18, 0, 0, 0, -2, 16
"c:\Users\Lenovo\Desktop\aps\src\components\Profiles\DepartmentProfile\Exam\CommitteMembers.js", "JavaScript", 31, 0, 0, 0, 0, 31
"c:\Users\Lenovo\Desktop\aps\src\components\Profiles\DepartmentProfile\Exam\ExamComitte.js", "JavaScript", 6, 0, 0, 0, -1, 5
"c:\Users\Lenovo\Desktop\aps\src\components\Profiles\DepartmentProfile\Exam\Exams.js", "JavaScript", 12, 0, 0, 0, -1, 11
"c:\Users\Lenovo\Desktop\aps\src\components\Profiles\DepartmentProfile\Exam\Grades.js", "JavaScript", 111, 0, 0, 3, 4, 118
"c:\Users\Lenovo\Desktop\aps\src\components\Profiles\DepartmentProfile\Modules_s\AddNewModule.js", "JavaScript", -4, 0, 0, 4, 0, 0
"c:\Users\Lenovo\Desktop\aps\src\components\Profiles\DepartmentProfile\Modules_s\Options.module.css", "CSS", 0, 0, 36, 0, 2, 38
"c:\Users\Lenovo\Desktop\aps\src\components\Profiles\DepartmentProfile\Programs\AddProgram.module.css", "CSS", 0, 0, 2, 0, 0, 2
"c:\Users\Lenovo\Desktop\aps\src\components\Profiles\DepartmentProfile\Programs\AddProgramModule.js", "JavaScript", 117, 0, 0, 0, 3, 120
"c:\Users\Lenovo\Desktop\aps\src\components\Profiles\DepartmentProfile\Programs\AddProgramModule.module.css", "CSS", 0, 0, 147, 0, 7, 154
"c:\Users\Lenovo\Desktop\aps\src\components\Profiles\DepartmentProfile\Programs\ModuleInfo.js", "JavaScript", 323, 0, 0, 2, 6, 331
"c:\Users\Lenovo\Desktop\aps\src\components\Profiles\DepartmentProfile\Programs\ModuleInfo.module.css", "CSS", 0, 0, 190, 0, 16, 206
"c:\Users\Lenovo\Desktop\aps\src\components\Profiles\DepartmentProfile\Programs\add_program_module\AddBook.js", "JavaScript", 2, 0, 0, 0, 0, 2
"c:\Users\Lenovo\Desktop\aps\src\components\Profiles\DepartmentProfile\Programs\add_program_module\AddProgramModule.js", "JavaScript", 32, 0, 0, 0, 2, 34
"c:\Users\Lenovo\Desktop\aps\src\components\Profiles\DepartmentProfile\Programs\add_program_module\EditProgramModule.js", "JavaScript", 38, 0, 0, 0, 1, 39
"c:\Users\Lenovo\Desktop\aps\src\components\Profiles\DepartmentProfile\Programs\add_program_module\ModuleAssesment.js", "JavaScript", 1, 0, 0, 0, -2, -1
"c:\Users\Lenovo\Desktop\aps\src\components\Profiles\DepartmentProfile\StudentsModuleRegisteration.js", "JavaScript", 37, 0, 0, 0, 2, 39
"c:\Users\Lenovo\Desktop\aps\src\components\Profiles\DepartmentProfile\ViewDepartmentProfile.js", "JavaScript", 320, 0, 0, 2, 7, 329
"c:\Users\Lenovo\Desktop\aps\src\components\Profiles\ProfessorProfile\AddAssesments.js", "JavaScript", 4, 0, 0, 0, 0, 4
"c:\Users\Lenovo\Desktop\aps\src\components\Profiles\ProfessorProfile\AssesmentGradesTable.js", "JavaScript", 90, 0, 0, 0, 12, 102
"c:\Users\Lenovo\Desktop\aps\src\components\Profiles\ProfessorProfile\Assesments.js", "JavaScript", 6, 0, 0, 0, 0, 6
"c:\Users\Lenovo\Desktop\aps\src\components\Profiles\ProfessorProfile\Home\ProfessorHome.js", "JavaScript", 31, 0, 0, 0, 1, 32
"c:\Users\Lenovo\Desktop\aps\src\components\Profiles\ProfessorProfile\Home\ProfessorInfoCard.js", "JavaScript", 91, 0, 0, 4, 2, 97
"c:\Users\Lenovo\Desktop\aps\src\components\Profiles\ProfessorProfile\Modules\ModuleStudents.js", "JavaScript", 0, 0, 0, 0, 1, 1
"c:\Users\Lenovo\Desktop\aps\src\components\Profiles\ProfessorProfile\Modules\ProfessorModules.js", "JavaScript", 2, 0, 0, 0, 0, 2
"c:\Users\Lenovo\Desktop\aps\src\components\Profiles\ProfessorProfile\Modules\StudentGrades.js", "JavaScript", 95, 0, 0, 0, 2, 97
"c:\Users\Lenovo\Desktop\aps\src\components\Profiles\ProfessorProfile\ProfessorProfile.js", "JavaScript", 113, 0, 0, 0, 5, 118
"c:\Users\Lenovo\Desktop\aps\src\components\Profiles\ProfessorProfile\StudentsAttendance.js", "JavaScript", 186, 0, 0, 0, 5, 191
"c:\Users\Lenovo\Desktop\aps\src\components\Profiles\StudentProfile\Home\Home.js", "JavaScript", 65, 0, 0, 1, 4, 70
"c:\Users\Lenovo\Desktop\aps\src\components\Profiles\StudentProfile\Home\InfoCards.js", "JavaScript", 4, 0, 0, 0, 0, 4
"c:\Users\Lenovo\Desktop\aps\src\components\Profiles\StudentProfile\Home\Posts.js", "JavaScript", 8, 0, 0, 0, 0, 8
"c:\Users\Lenovo\Desktop\aps\src\components\Profiles\StudentProfile\Home\StudentCalendar.js", "JavaScript", 37, 0, 0, 0, 0, 37
"c:\Users\Lenovo\Desktop\aps\src\components\Profiles\StudentProfile\Home\TodaySchedule.js", "JavaScript", 11, 0, 0, 0, 1, 12
"c:\Users\Lenovo\Desktop\aps\src\components\Profiles\StudentProfile\Home\UpcomingClasses.js", "JavaScript", 12, 0, 0, 0, 0, 12
"c:\Users\Lenovo\Desktop\aps\src\components\Profiles\StudentProfile\ModulesRegisteration.js", "JavaScript", 21, 0, 0, 0, 2, 23
"c:\Users\Lenovo\Desktop\aps\src\components\Profiles\StudentProfile\Modules\ModuleAttendance.js", "JavaScript", 68, 0, 0, 2, 3, 73
"c:\Users\Lenovo\Desktop\aps\src\components\Profiles\StudentProfile\Modules\StudentModules.js", "JavaScript", -3, 0, 0, 0, 0, -3
"c:\Users\Lenovo\Desktop\aps\src\components\Profiles\StudentProfile\Modules\ViewGrade.js", "JavaScript", 117, 0, 0, 1, 3, 121
"c:\Users\Lenovo\Desktop\aps\src\components\Profiles\StudentProfile\Modules\ViewModule.js", "JavaScript", 31, 0, 0, 0, 0, 31
"c:\Users\Lenovo\Desktop\aps\src\components\Profiles\StudentProfile\PresenceTable.js", "JavaScript", 5, 0, 0, 0, 0, 5
"c:\Users\Lenovo\Desktop\aps\src\components\Profiles\StudentProfile\StudentPresence.js", "JavaScript", 21, 0, 0, 36, -2, 55
"c:\Users\Lenovo\Desktop\aps\src\components\Profiles\UniversityProfile\AboutComponent.js", "JavaScript", 2, 0, 0, 0, 0, 2
"c:\Users\Lenovo\Desktop\aps\src\components\login\Login.js", "JavaScript", 1, 0, 0, 0, 0, 1
"c:\Users\Lenovo\Desktop\aps\src\components\navbar\Navbar.js", "JavaScript", 13, 0, 0, 0, 6, 19
"c:\Users\Lenovo\Desktop\aps\src\store\auth-slice.js", "JavaScript", 2, 0, 0, 0, 0, 2
"c:\Users\Lenovo\Desktop\aps\src\store\fire.jsx", "JavaScript JSX", 0, 10, 0, 0, 0, 10
"c:\Users\Lenovo\Desktop\aps\src\store\getandset.js", "JavaScript", 253, 0, 0, 1, 12, 266
"c:\Users\Lenovo\Desktop\aps\src\store\notify-slice.js", "JavaScript", 8, 0, 0, 0, 1, 9
"Total", "-", 2358, 10, 375, 56, 107, 2906