"filename", "language", "JavaScript", "JSON", "JavaScript JSX", "CSS", "XML", "comment", "blank", "total"
"c:\Users\Lenovo\Desktop\aps\src\App.js", "JavaScript", 245, 0, 0, 0, 0, 0, 18, 263
"c:\Users\Lenovo\Desktop\aps\src\components\Error.js", "JavaScript", 15, 0, 0, 0, 0, 0, 2, 17
"c:\Users\Lenovo\Desktop\aps\src\components\Error.module.css", "CSS", 0, 0, 0, 25, 0, 0, 0, 25
"c:\Users\Lenovo\Desktop\aps\src\components\MainPage\MainPage.js", "JavaScript", 122, 0, 0, 0, 0, 0, 9, 131
"c:\Users\Lenovo\Desktop\aps\src\components\MainPage\MainPage.module.css", "CSS", 0, 0, 0, 218, 0, 0, 23, 241
"c:\Users\Lenovo\Desktop\aps\src\components\MainPage\reshot-icon-right-arrow-UCA8NGYZDJ.svg", "XML", 0, 0, 0, 0, 1, 0, 0, 1
"c:\Users\Lenovo\Desktop\aps\src\components\Notifications\Notifications.js", "JavaScript", 105, 0, 0, 0, 0, 0, 8, 113
"c:\Users\Lenovo\Desktop\aps\src\components\Notifications\Notifications.module.css", "CSS", 0, 0, 0, 173, 0, 0, 2, 175
"c:\Users\Lenovo\Desktop\aps\src\components\Profiles\CollegeProfile\AddDepartment.js", "JavaScript", 167, 0, 0, 0, 0, 0, 8, 175
"c:\Users\Lenovo\Desktop\aps\src\components\Profiles\CollegeProfile\AddDepartment.module.css", "CSS", 0, 0, 0, 150, 0, 0, 12, 162
"c:\Users\Lenovo\Desktop\aps\src\components\Profiles\CollegeProfile\AddStudent\AddStudent.css", "CSS", 0, 0, 0, 261, 0, 14, 15, 290
"c:\Users\Lenovo\Desktop\aps\src\components\Profiles\CollegeProfile\AddStudent\AddStudent.jsx", "JavaScript JSX", 0, 0, 266, 0, 0, 2, 4, 272
"c:\Users\Lenovo\Desktop\aps\src\components\Profiles\CollegeProfile\AddStudent\Button.jsx", "JavaScript JSX", 0, 0, 20, 0, 0, 0, 1, 21
"c:\Users\Lenovo\Desktop\aps\src\components\Profiles\CollegeProfile\AddStudent\Largeinput.jsx", "JavaScript JSX", 0, 0, 19, 0, 0, 0, 0, 19
"c:\Users\Lenovo\Desktop\aps\src\components\Profiles\CollegeProfile\AddStudent\SelectLevel.jsx", "JavaScript JSX", 0, 0, 48, 0, 0, 0, 3, 51
"c:\Users\Lenovo\Desktop\aps\src\components\Profiles\CollegeProfile\AddStudent\SelectProgram.jsx", "JavaScript JSX", 0, 0, 111, 0, 0, 0, 3, 114
"c:\Users\Lenovo\Desktop\aps\src\components\Profiles\CollegeProfile\AddStudent\SelectStep.jsx", "JavaScript JSX", 0, 0, 21, 0, 0, 0, 2, 23
"c:\Users\Lenovo\Desktop\aps\src\components\Profiles\CollegeProfile\AddStudent\Smallinput.jsx", "JavaScript JSX", 0, 0, 19, 0, 0, 0, 1, 20
"c:\Users\Lenovo\Desktop\aps\src\components\Profiles\CollegeProfile\AddStudent\Stepone.jsx", "JavaScript JSX", 0, 0, 54, 0, 0, 0, 0, 54
"c:\Users\Lenovo\Desktop\aps\src\components\Profiles\CollegeProfile\AddStudent\Steptwo.jsx", "JavaScript JSX", 0, 0, 94, 0, 0, 0, 12, 106
"c:\Users\Lenovo\Desktop\aps\src\components\Profiles\CollegeProfile\AddStudent\style.module.css", "CSS", 0, 0, 0, 28, 0, 0, 1, 29
"c:\Users\Lenovo\Desktop\aps\src\components\Profiles\CollegeProfile\CollegeProfile.js", "JavaScript", 326, 0, 0, 0, 0, 2, 3, 331
"c:\Users\Lenovo\Desktop\aps\src\components\Profiles\CollegeProfile\CollegeProfile.module.css", "CSS", 0, 0, 0, 399, 0, 0, 11, 410
"c:\Users\Lenovo\Desktop\aps\src\components\Profiles\CollegeProfile\StudentsTable\AddStudent.css", "CSS", 0, 0, 0, 270, 0, 14, 14, 298
"c:\Users\Lenovo\Desktop\aps\src\components\Profiles\CollegeProfile\StudentsTable\AddStudent.module.css", "CSS", 0, 0, 0, 270, 0, 14, 14, 298
"c:\Users\Lenovo\Desktop\aps\src\components\Profiles\CollegeProfile\StudentsTable\ChangeUsername.module.css", "CSS", 0, 0, 0, 69, 0, 0, 4, 73
"c:\Users\Lenovo\Desktop\aps\src\components\Profiles\CollegeProfile\StudentsTable\Changeusername.jsx", "JavaScript JSX", 0, 0, 129, 0, 0, 0, 3, 132
"c:\Users\Lenovo\Desktop\aps\src\components\Profiles\CollegeProfile\StudentsTable\EditStudent.css", "CSS", 0, 0, 0, 56, 0, 1, 8, 65
"c:\Users\Lenovo\Desktop\aps\src\components\Profiles\CollegeProfile\StudentsTable\EditStudent.jsx", "JavaScript JSX", 0, 0, 226, 0, 0, 2, 6, 234
"c:\Users\Lenovo\Desktop\aps\src\components\Profiles\CollegeProfile\StudentsTable\Options.js", "JavaScript", 29, 0, 0, 0, 0, 0, 2, 31
"c:\Users\Lenovo\Desktop\aps\src\components\Profiles\CollegeProfile\StudentsTable\Options.module.css", "CSS", 0, 0, 0, 36, 0, 0, 2, 38
"c:\Users\Lenovo\Desktop\aps\src\components\Profiles\CollegeProfile\StudentsTable\SelectLevel.jsx", "JavaScript JSX", 0, 0, 48, 0, 0, 0, 4, 52
"c:\Users\Lenovo\Desktop\aps\src\components\Profiles\CollegeProfile\StudentsTable\SelectProgram.jsx", "JavaScript JSX", 0, 0, 110, 0, 0, 0, 6, 116
"c:\Users\Lenovo\Desktop\aps\src\components\Profiles\CollegeProfile\StudentsTable\StudentsTable.jsx", "JavaScript JSX", 0, 0, 205, 0, 0, 1, 7, 213
"c:\Users\Lenovo\Desktop\aps\src\components\Profiles\CollegeProfile\StudentsTable\StudentsTable.module.css", "CSS", 0, 0, 0, 42, 0, 0, 0, 42
"c:\Users\Lenovo\Desktop\aps\src\components\Profiles\DepartmentProfile\AddLevel.js", "JavaScript", 104, 0, 0, 0, 0, 1, 7, 112
"c:\Users\Lenovo\Desktop\aps\src\components\Profiles\DepartmentProfile\AddLevel.module.css", "CSS", 0, 0, 0, 151, 0, 0, 12, 163
"c:\Users\Lenovo\Desktop\aps\src\components\Profiles\DepartmentProfile\AddModule.js", "JavaScript", 174, 0, 0, 0, 0, 1, 6, 181
"c:\Users\Lenovo\Desktop\aps\src\components\Profiles\DepartmentProfile\AddModule.module.css", "CSS", 0, 0, 0, 152, 0, 0, 12, 164
"c:\Users\Lenovo\Desktop\aps\src\components\Profiles\DepartmentProfile\AddPost.js", "JavaScript", 88, 0, 0, 0, 0, 0, 1, 89
"c:\Users\Lenovo\Desktop\aps\src\components\Profiles\DepartmentProfile\Classrooms\AddClass.js", "JavaScript", 192, 0, 0, 0, 0, 1, 12, 205
"c:\Users\Lenovo\Desktop\aps\src\components\Profiles\DepartmentProfile\Classrooms\AddClass.module.css", "CSS", 0, 0, 0, 179, 0, 0, 18, 197
"c:\Users\Lenovo\Desktop\aps\src\components\Profiles\DepartmentProfile\Classrooms\ClassroomsTable.js", "JavaScript", 157, 0, 0, 0, 0, 15, 12, 184
"c:\Users\Lenovo\Desktop\aps\src\components\Profiles\DepartmentProfile\Classrooms\ClassroomsTable.module.css", "CSS", 0, 0, 0, 65, 0, 0, 1, 66
"c:\Users\Lenovo\Desktop\aps\src\components\Profiles\DepartmentProfile\Classrooms\OptionsC.js", "JavaScript", 24, 0, 0, 0, 0, 1, 2, 27
"c:\Users\Lenovo\Desktop\aps\src\components\Profiles\DepartmentProfile\DepartmentProfile.js", "JavaScript", 346, 0, 0, 0, 0, 2, 4, 352
"c:\Users\Lenovo\Desktop\aps\src\components\Profiles\DepartmentProfile\DepartmentProfile.module.css", "CSS", 0, 0, 0, 422, 0, 0, 14, 436
"c:\Users\Lenovo\Desktop\aps\src\components\Profiles\DepartmentProfile\Divisions\AddDivision.js", "JavaScript", 56, 0, 0, 0, 0, 0, 1, 57
"c:\Users\Lenovo\Desktop\aps\src\components\Profiles\DepartmentProfile\Divisions\AddStudentsDivision.js", "JavaScript", 97, 0, 0, 0, 0, 0, 1, 98
"c:\Users\Lenovo\Desktop\aps\src\components\Profiles\DepartmentProfile\Divisions\Divsion.js", "JavaScript", 315, 0, 0, 0, 0, 1, 25, 341
"c:\Users\Lenovo\Desktop\aps\src\components\Profiles\DepartmentProfile\Exam\AddCommite.js", "JavaScript", 153, 0, 0, 0, 0, 0, 4, 157
"c:\Users\Lenovo\Desktop\aps\src\components\Profiles\DepartmentProfile\Exam\AddExam.js", "JavaScript", 185, 0, 0, 0, 0, 0, 0, 185
"c:\Users\Lenovo\Desktop\aps\src\components\Profiles\DepartmentProfile\Exam\CommitteMembers.js", "JavaScript", 266, 0, 0, 0, 0, 3, 2, 271
"c:\Users\Lenovo\Desktop\aps\src\components\Profiles\DepartmentProfile\Exam\ExamComitte.js", "JavaScript", 369, 0, 0, 0, 0, 1, 5, 375
"c:\Users\Lenovo\Desktop\aps\src\components\Profiles\DepartmentProfile\Exam\Exams.js", "JavaScript", 283, 0, 0, 0, 0, 1, 14, 298
"c:\Users\Lenovo\Desktop\aps\src\components\Profiles\DepartmentProfile\Exam\Grades.js", "JavaScript", 439, 0, 0, 0, 0, 5, 22, 466
"c:\Users\Lenovo\Desktop\aps\src\components\Profiles\DepartmentProfile\Exam\temp.js", "JavaScript", 217, 0, 0, 0, 0, 0, 19, 236
"c:\Users\Lenovo\Desktop\aps\src\components\Profiles\DepartmentProfile\LevelModule.js", "JavaScript", 156, 0, 0, 0, 0, 0, 2, 158
"c:\Users\Lenovo\Desktop\aps\src\components\Profiles\DepartmentProfile\LevelModules.module.css", "CSS", 0, 0, 0, 132, 0, 0, 0, 132
"c:\Users\Lenovo\Desktop\aps\src\components\Profiles\DepartmentProfile\Modules.js", "JavaScript", 41, 0, 0, 0, 0, 0, 5, 46
"c:\Users\Lenovo\Desktop\aps\src\components\Profiles\DepartmentProfile\Modules.module.css", "CSS", 0, 0, 0, 49, 0, 0, 0, 49
"c:\Users\Lenovo\Desktop\aps\src\components\Profiles\DepartmentProfile\Modules_s\AddNewModule.js", "JavaScript", 355, 0, 0, 0, 0, 5, 12, 372
"c:\Users\Lenovo\Desktop\aps\src\components\Profiles\DepartmentProfile\Modules_s\AddNewModule.module.css", "CSS", 0, 0, 0, 262, 0, 0, 13, 275
"c:\Users\Lenovo\Desktop\aps\src\components\Profiles\DepartmentProfile\Modules_s\EditModule.js", "JavaScript", 387, 0, 0, 0, 0, 31, 21, 439
"c:\Users\Lenovo\Desktop\aps\src\components\Profiles\DepartmentProfile\Modules_s\ModulesTable.js", "JavaScript", 130, 0, 0, 0, 0, 0, 10, 140
"c:\Users\Lenovo\Desktop\aps\src\components\Profiles\DepartmentProfile\Modules_s\ModulesTable.module.css", "CSS", 0, 0, 0, 42, 0, 0, 0, 42
"c:\Users\Lenovo\Desktop\aps\src\components\Profiles\DepartmentProfile\Modules_s\Options.js", "JavaScript", 18, 0, 0, 0, 0, 1, 0, 19
"c:\Users\Lenovo\Desktop\aps\src\components\Profiles\DepartmentProfile\Modules_s\Options.module.css", "CSS", 0, 0, 0, 36, 0, 0, 2, 38
"c:\Users\Lenovo\Desktop\aps\src\components\Profiles\DepartmentProfile\Proffessor\AddProffessor.js", "JavaScript", 334, 0, 0, 0, 0, 1, 24, 359
"c:\Users\Lenovo\Desktop\aps\src\components\Profiles\DepartmentProfile\Proffessor\AddProffessor.module.css", "CSS", 0, 0, 0, 273, 0, 0, 13, 286
"c:\Users\Lenovo\Desktop\aps\src\components\Profiles\DepartmentProfile\Proffessor\EditProfessor.js", "JavaScript", 342, 0, 0, 0, 0, 13, 27, 382
"c:\Users\Lenovo\Desktop\aps\src\components\Profiles\DepartmentProfile\Proffessor\PrefessorTable.js", "JavaScript", 188, 0, 0, 0, 0, 1, 10, 199
"c:\Users\Lenovo\Desktop\aps\src\components\Profiles\DepartmentProfile\Proffessor\ProfessorTable.module.css", "CSS", 0, 0, 0, 42, 0, 0, 0, 42
"c:\Users\Lenovo\Desktop\aps\src\components\Profiles\DepartmentProfile\Programs\AddProgram.js", "JavaScript", 398, 0, 0, 0, 0, 1, 9, 408
"c:\Users\Lenovo\Desktop\aps\src\components\Profiles\DepartmentProfile\Programs\AddProgram.module.css", "CSS", 0, 0, 0, 268, 0, 0, 13, 281
"c:\Users\Lenovo\Desktop\aps\src\components\Profiles\DepartmentProfile\Programs\AddProgramModule.js", "JavaScript", 117, 0, 0, 0, 0, 0, 3, 120
"c:\Users\Lenovo\Desktop\aps\src\components\Profiles\DepartmentProfile\Programs\AddProgramModule.module.css", "CSS", 0, 0, 0, 147, 0, 0, 7, 154
"c:\Users\Lenovo\Desktop\aps\src\components\Profiles\DepartmentProfile\Programs\AddSpeciality.js", "JavaScript", 193, 0, 0, 0, 0, 1, 12, 206
"c:\Users\Lenovo\Desktop\aps\src\components\Profiles\DepartmentProfile\Programs\AddSpeciality.module.css", "CSS", 0, 0, 0, 111, 0, 0, 4, 115
"c:\Users\Lenovo\Desktop\aps\src\components\Profiles\DepartmentProfile\Programs\BachelorFive.jsx", "JavaScript JSX", 0, 0, 51, 0, 0, 0, 1, 52
"c:\Users\Lenovo\Desktop\aps\src\components\Profiles\DepartmentProfile\Programs\BachelorFour.js", "JavaScript", 52, 0, 0, 0, 0, 0, 2, 54
"c:\Users\Lenovo\Desktop\aps\src\components\Profiles\DepartmentProfile\Programs\BachelorFour.module.css", "CSS", 0, 0, 0, 128, 0, 0, 2, 130
"c:\Users\Lenovo\Desktop\aps\src\components\Profiles\DepartmentProfile\Programs\DisplayLevels.js", "JavaScript", 46, 0, 0, 0, 0, 0, 2, 48
"c:\Users\Lenovo\Desktop\aps\src\components\Profiles\DepartmentProfile\Programs\HOC.jsx", "JavaScript JSX", 0, 0, 48, 0, 0, 0, 1, 49
"c:\Users\Lenovo\Desktop\aps\src\components\Profiles\DepartmentProfile\Programs\ModuleInfo.js", "JavaScript", 323, 0, 0, 0, 0, 2, 6, 331
"c:\Users\Lenovo\Desktop\aps\src\components\Profiles\DepartmentProfile\Programs\ModuleInfo.module.css", "CSS", 0, 0, 0, 190, 0, 0, 16, 206
"c:\Users\Lenovo\Desktop\aps\src\components\Profiles\DepartmentProfile\Programs\PreviewBachelor.js", "JavaScript", 83, 0, 0, 0, 0, 0, 2, 85
"c:\Users\Lenovo\Desktop\aps\src\components\Profiles\DepartmentProfile\Programs\PreviewBachelor.module.css", "CSS", 0, 0, 0, 110, 0, 0, 2, 112
"c:\Users\Lenovo\Desktop\aps\src\components\Profiles\DepartmentProfile\Programs\ProgramManage.js", "JavaScript", 86, 0, 0, 0, 0, 4, 1, 91
"c:\Users\Lenovo\Desktop\aps\src\components\Profiles\DepartmentProfile\Programs\ProgramManage.module.css", "CSS", 0, 0, 0, 106, 0, 0, 9, 115
"c:\Users\Lenovo\Desktop\aps\src\components\Profiles\DepartmentProfile\Programs\ProgramModules\ProgramModulesTable.js", "JavaScript", 314, 0, 0, 0, 0, 1, 17, 332
"c:\Users\Lenovo\Desktop\aps\src\components\Profiles\DepartmentProfile\Programs\ProgramModules\ProgramModulesTable.module.css", "CSS", 0, 0, 0, 42, 0, 0, 0, 42
"c:\Users\Lenovo\Desktop\aps\src\components\Profiles\DepartmentProfile\Programs\Speciality.js", "JavaScript", 146, 0, 0, 0, 0, 1, 6, 153
"c:\Users\Lenovo\Desktop\aps\src\components\Profiles\DepartmentProfile\Programs\Speciality.module.css", "CSS", 0, 0, 0, 53, 0, 0, 2, 55
"c:\Users\Lenovo\Desktop\aps\src\components\Profiles\DepartmentProfile\Programs\add_program_module\AddBook.js", "JavaScript", 97, 0, 0, 0, 0, 7, 3, 107
"c:\Users\Lenovo\Desktop\aps\src\components\Profiles\DepartmentProfile\Programs\add_program_module\AddProgramModule.js", "JavaScript", 264, 0, 0, 0, 0, 1, 5, 270
"c:\Users\Lenovo\Desktop\aps\src\components\Profiles\DepartmentProfile\Programs\add_program_module\AddProgramModule.module.css", "CSS", 0, 0, 0, 157, 0, 0, 12, 169
"c:\Users\Lenovo\Desktop\aps\src\components\Profiles\DepartmentProfile\Programs\add_program_module\AddUnstructHours.js", "JavaScript", 68, 0, 0, 0, 0, 0, 4, 72
"c:\Users\Lenovo\Desktop\aps\src\components\Profiles\DepartmentProfile\Programs\add_program_module\EditProgramModule.js", "JavaScript", 270, 0, 0, 0, 0, 1, 4, 275
"c:\Users\Lenovo\Desktop\aps\src\components\Profiles\DepartmentProfile\Programs\add_program_module\ModuleAssesment.js", "JavaScript", 215, 0, 0, 0, 0, 1, 3, 219
"c:\Users\Lenovo\Desktop\aps\src\components\Profiles\DepartmentProfile\Programs\add_program_module\ModuleInfo.js", "JavaScript", 358, 0, 0, 0, 0, 2, 5, 365
"c:\Users\Lenovo\Desktop\aps\src\components\Profiles\DepartmentProfile\Programs\add_program_module\ModuleInfo.module.css", "CSS", 0, 0, 0, 202, 0, 0, 17, 219
"c:\Users\Lenovo\Desktop\aps\src\components\Profiles\DepartmentProfile\Programs\add_program_module\ModuleLab.js", "JavaScript", 62, 0, 0, 0, 0, 0, 5, 67
"c:\Users\Lenovo\Desktop\aps\src\components\Profiles\DepartmentProfile\Programs\add_program_module\ModuleSources.js", "JavaScript", 68, 0, 0, 0, 0, 0, 3, 71
"c:\Users\Lenovo\Desktop\aps\src\components\Profiles\DepartmentProfile\Programs\add_program_module\ModuleSrtructuredHours.js", "JavaScript", 174, 0, 0, 0, 0, 2, 6, 182
"c:\Users\Lenovo\Desktop\aps\src\components\Profiles\DepartmentProfile\Programs\add_program_module\ModuleStructuredHours.module.css", "CSS", 0, 0, 0, 110, 0, 0, 3, 113
"c:\Users\Lenovo\Desktop\aps\src\components\Profiles\DepartmentProfile\Programs\add_program_module\ModuleTheory.js", "JavaScript", 65, 0, 0, 0, 0, 0, 4, 69
"c:\Users\Lenovo\Desktop\aps\src\components\Profiles\DepartmentProfile\Programs\add_program_module\ModuleUnstructHours.js", "JavaScript", 166, 0, 0, 0, 0, 2, 5, 173
"c:\Users\Lenovo\Desktop\aps\src\components\Profiles\DepartmentProfile\StudentsModuleRegisteration.js", "JavaScript", 332, 0, 0, 0, 0, 1, 18, 351
"c:\Users\Lenovo\Desktop\aps\src\components\Profiles\DepartmentProfile\ViewDepartmentProfile.js", "JavaScript", 320, 0, 0, 0, 0, 2, 7, 329
"c:\Users\Lenovo\Desktop\aps\src\components\Profiles\DepartmentProfile\schedule\AddScheduling.js", "JavaScript", 364, 0, 0, 0, 0, 4, 13, 381
"c:\Users\Lenovo\Desktop\aps\src\components\Profiles\DepartmentProfile\schedule\Schedule.js", "JavaScript", 396, 0, 0, 0, 0, 3, 11, 410
"c:\Users\Lenovo\Desktop\aps\src\components\Profiles\DepartmentProfile\schedule\ScheduleTable.js", "JavaScript", 170, 0, 0, 0, 0, 1, 6, 177
"c:\Users\Lenovo\Desktop\aps\src\components\Profiles\ProfessorProfile\AddAssesments.js", "JavaScript", 254, 0, 0, 0, 0, 0, 6, 260
"c:\Users\Lenovo\Desktop\aps\src\components\Profiles\ProfessorProfile\AssesmentGradesTable.js", "JavaScript", 293, 0, 0, 0, 0, 0, 35, 328
"c:\Users\Lenovo\Desktop\aps\src\components\Profiles\ProfessorProfile\Assesments.js", "JavaScript", 173, 0, 0, 0, 0, 0, 5, 178
"c:\Users\Lenovo\Desktop\aps\src\components\Profiles\ProfessorProfile\Home\ProfessorHome.js", "JavaScript", 109, 0, 0, 0, 0, 1, 3, 113
"c:\Users\Lenovo\Desktop\aps\src\components\Profiles\ProfessorProfile\Home\ProfessorInfoCard.js", "JavaScript", 91, 0, 0, 0, 0, 4, 2, 97
"c:\Users\Lenovo\Desktop\aps\src\components\Profiles\ProfessorProfile\Modules\ModuleStudents.js", "JavaScript", 127, 0, 0, 0, 0, 0, 10, 137
"c:\Users\Lenovo\Desktop\aps\src\components\Profiles\ProfessorProfile\Modules\ProfessorModules.js", "JavaScript", 146, 0, 0, 0, 0, 2, 2, 150
"c:\Users\Lenovo\Desktop\aps\src\components\Profiles\ProfessorProfile\Modules\StudentGrades.js", "JavaScript", 223, 0, 0, 0, 0, 0, 8, 231
"c:\Users\Lenovo\Desktop\aps\src\components\Profiles\ProfessorProfile\ProfessorProfile.js", "JavaScript", 113, 0, 0, 0, 0, 0, 5, 118
"c:\Users\Lenovo\Desktop\aps\src\components\Profiles\ProfessorProfile\StudentsAttendance.js", "JavaScript", 548, 0, 0, 0, 0, 1, 34, 583
"c:\Users\Lenovo\Desktop\aps\src\components\Profiles\StudentProfile\EditProfile.js", "JavaScript", 225, 0, 0, 0, 0, 1, 4, 230
"c:\Users\Lenovo\Desktop\aps\src\components\Profiles\StudentProfile\EditProfile.module.css", "CSS", 0, 0, 0, 73, 0, 0, 3, 76
"c:\Users\Lenovo\Desktop\aps\src\components\Profiles\StudentProfile\Home\Home.js", "JavaScript", 200, 0, 0, 0, 0, 2, 9, 211
"c:\Users\Lenovo\Desktop\aps\src\components\Profiles\StudentProfile\Home\InfoCards.js", "JavaScript", 65, 0, 0, 0, 0, 0, 1, 66
"c:\Users\Lenovo\Desktop\aps\src\components\Profiles\StudentProfile\Home\Posts.js", "JavaScript", 53, 0, 0, 0, 0, 0, 1, 54
"c:\Users\Lenovo\Desktop\aps\src\components\Profiles\StudentProfile\Home\StudentCalendar.js", "JavaScript", 147, 0, 0, 0, 0, 0, 6, 153
"c:\Users\Lenovo\Desktop\aps\src\components\Profiles\StudentProfile\Home\TodaySchedule.js", "JavaScript", 121, 0, 0, 0, 0, 0, 3, 124
"c:\Users\Lenovo\Desktop\aps\src\components\Profiles\StudentProfile\Home\UpcomingClasses.js", "JavaScript", 67, 0, 0, 0, 0, 0, 4, 71
"c:\Users\Lenovo\Desktop\aps\src\components\Profiles\StudentProfile\ModulesRegisteration.js", "JavaScript", 340, 0, 0, 0, 0, 2, 12, 354
"c:\Users\Lenovo\Desktop\aps\src\components\Profiles\StudentProfile\Modules\ModuleAttendance.js", "JavaScript", 175, 0, 0, 0, 0, 2, 9, 186
"c:\Users\Lenovo\Desktop\aps\src\components\Profiles\StudentProfile\Modules\StudentModules.js", "JavaScript", 145, 0, 0, 0, 0, 2, 2, 149
"c:\Users\Lenovo\Desktop\aps\src\components\Profiles\StudentProfile\Modules\ViewGrade.js", "JavaScript", 198, 0, 0, 0, 0, 1, 5, 204
"c:\Users\Lenovo\Desktop\aps\src\components\Profiles\StudentProfile\Modules\ViewModule.js", "JavaScript", 392, 0, 0, 0, 0, 0, 7, 399
"c:\Users\Lenovo\Desktop\aps\src\components\Profiles\StudentProfile\PresenceTable.js", "JavaScript", 70, 0, 0, 0, 0, 0, 3, 73
"c:\Users\Lenovo\Desktop\aps\src\components\Profiles\StudentProfile\StudentPresence.js", "JavaScript", 264, 0, 0, 0, 0, 36, 5, 305
"c:\Users\Lenovo\Desktop\aps\src\components\Profiles\StudentProfile\StudentProfile.js", "JavaScript", 118, 0, 0, 0, 0, 0, 5, 123
"c:\Users\Lenovo\Desktop\aps\src\components\Profiles\UniversityProfile\AboutComponent.js", "JavaScript", 59, 0, 0, 0, 0, 2, 0, 61
"c:\Users\Lenovo\Desktop\aps\src\components\Profiles\UniversityProfile\AboutComponent.module.css", "CSS", 0, 0, 0, 58, 0, 0, 1, 59
"c:\Users\Lenovo\Desktop\aps\src\components\Profiles\UniversityProfile\AddCollege.js", "JavaScript", 171, 0, 0, 0, 0, 0, 9, 180
"c:\Users\Lenovo\Desktop\aps\src\components\Profiles\UniversityProfile\AddCollege.module.css", "CSS", 0, 0, 0, 150, 0, 0, 12, 162
"c:\Users\Lenovo\Desktop\aps\src\components\Profiles\UniversityProfile\CustomInput.js", "JavaScript", 58, 0, 0, 0, 0, 0, 0, 58
"c:\Users\Lenovo\Desktop\aps\src\components\Profiles\UniversityProfile\CustomInput.module.css", "CSS", 0, 0, 0, 73, 0, 0, 2, 75
"c:\Users\Lenovo\Desktop\aps\src\components\Profiles\UniversityProfile\EditProfile.js", "JavaScript", 290, 0, 0, 0, 0, 1, 4, 295
"c:\Users\Lenovo\Desktop\aps\src\components\Profiles\UniversityProfile\EditProfile.module.css", "CSS", 0, 0, 0, 73, 0, 0, 3, 76
"c:\Users\Lenovo\Desktop\aps\src\components\Profiles\UniversityProfile\UniversityProfile.js", "JavaScript", 258, 0, 0, 0, 0, 2, 2, 262
"c:\Users\Lenovo\Desktop\aps\src\components\Profiles\UniversityProfile\UniversityProfile.module.css", "CSS", 0, 0, 0, 381, 0, 0, 9, 390
"c:\Users\Lenovo\Desktop\aps\src\components\Profiles\UniversityProfile\preview.js", "JavaScript", 102, 0, 0, 0, 0, 0, 6, 108
"c:\Users\Lenovo\Desktop\aps\src\components\Profiles\library\Library.js", "JavaScript", 145, 0, 0, 0, 0, 1, 2, 148
"c:\Users\Lenovo\Desktop\aps\src\components\Root.js", "JavaScript", 58, 0, 0, 0, 0, 0, 4, 62
"c:\Users\Lenovo\Desktop\aps\src\components\Root.module.css", "CSS", 0, 0, 0, 45, 0, 0, 0, 45
"c:\Users\Lenovo\Desktop\aps\src\components\UI\BaiscSwitch.js", "JavaScript", 45, 0, 0, 0, 0, 0, 2, 47
"c:\Users\Lenovo\Desktop\aps\src\components\UI\Confirm\Confirm.js", "JavaScript", 46, 0, 0, 0, 0, 0, 2, 48
"c:\Users\Lenovo\Desktop\aps\src\components\UI\ErrorBox\ErrorBox.js", "JavaScript", 27, 0, 0, 0, 0, 0, 0, 27
"c:\Users\Lenovo\Desktop\aps\src\components\UI\ErrorBox\ErrorBox.module.css", "CSS", 0, 0, 0, 43, 0, 0, 8, 51
"c:\Users\Lenovo\Desktop\aps\src\components\UI\Form\ReactSelect.jsx", "JavaScript JSX", 0, 0, 35, 0, 0, 0, 1, 36
"c:\Users\Lenovo\Desktop\aps\src\components\UI\Loader\Button\Button.js", "JavaScript", 10, 0, 0, 0, 0, 0, 0, 10
"c:\Users\Lenovo\Desktop\aps\src\components\UI\Loader\Button\Button.module.css", "CSS", 0, 0, 0, 13, 0, 0, 0, 13
"c:\Users\Lenovo\Desktop\aps\src\components\UI\Loader\Loader.js", "JavaScript", 13, 0, 0, 0, 0, 0, 2, 15
"c:\Users\Lenovo\Desktop\aps\src\components\UI\Loader\Loader.module.css", "CSS", 0, 0, 0, 40, 0, 0, 2, 42
"c:\Users\Lenovo\Desktop\aps\src\components\UI\Loader\Myloader.js", "JavaScript", 13, 0, 0, 0, 0, 0, 2, 15
"c:\Users\Lenovo\Desktop\aps\src\components\UI\Loader\PlaceHolderLoader.js", "JavaScript", 15, 0, 0, 0, 0, 0, 0, 15
"c:\Users\Lenovo\Desktop\aps\src\components\UI\Loader\PlaceHolderLoader.module.css", "CSS", 0, 0, 0, 60, 0, 0, 1, 61
"c:\Users\Lenovo\Desktop\aps\src\components\UI\Loader\myLoader.module.css", "CSS", 0, 0, 0, 39, 0, 0, 3, 42
"c:\Users\Lenovo\Desktop\aps\src\components\UI\Menu.js", "JavaScript", 45, 0, 0, 0, 0, 0, 2, 47
"c:\Users\Lenovo\Desktop\aps\src\components\UI\progressBar\LinearProgressWithLabel.js", "JavaScript", 33, 0, 0, 0, 0, 4, 5, 42
"c:\Users\Lenovo\Desktop\aps\src\components\login\Login.js", "JavaScript", 191, 0, 0, 0, 0, 0, 17, 208
"c:\Users\Lenovo\Desktop\aps\src\components\login\Login.module.css", "CSS", 0, 0, 0, 197, 0, 0, 9, 206
"c:\Users\Lenovo\Desktop\aps\src\components\navbar\Navbar.js", "JavaScript", 314, 0, 0, 0, 0, 2, 16, 332
"c:\Users\Lenovo\Desktop\aps\src\components\navbar\Navbar.module.css", "CSS", 0, 0, 0, 302, 0, 8, 14, 324
"c:\Users\Lenovo\Desktop\aps\src\components\universityAccounts\AddUniversity.js", "JavaScript", 163, 0, 0, 0, 0, 1, 8, 172
"c:\Users\Lenovo\Desktop\aps\src\components\universityAccounts\AddUniversity.module.css", "CSS", 0, 0, 0, 150, 0, 0, 12, 162
"c:\Users\Lenovo\Desktop\aps\src\components\universityAccounts\UniversityAccounts.js", "JavaScript", 217, 0, 0, 0, 0, 0, 11, 228
"c:\Users\Lenovo\Desktop\aps\src\components\universityAccounts\UniversityAccounts.module.css", "CSS", 0, 0, 0, 171, 0, 0, 2, 173
"c:\Users\Lenovo\Desktop\aps\src\hooks\useFetch.jsx", "JavaScript JSX", 0, 0, 28, 0, 0, 0, 1, 29
"c:\Users\Lenovo\Desktop\aps\src\hooks\useOneFetch.jsx", "JavaScript JSX", 0, 0, 25, 0, 0, 0, 0, 25
"c:\Users\Lenovo\Desktop\aps\src\hooks\usePaginationFetch.jsx", "JavaScript JSX", 0, 0, 47, 0, 0, 1, 2, 50
"c:\Users\Lenovo\Desktop\aps\src\hooks\useStudents.jsx", "JavaScript JSX", 0, 0, 24, 0, 0, 0, 1, 25
"c:\Users\Lenovo\Desktop\aps\src\hooks\useSubjects.jsx", "JavaScript JSX", 0, 0, 39, 0, 0, 4, 6, 49
"c:\Users\Lenovo\Desktop\aps\src\index.css", "CSS", 0, 0, 0, 24, 0, 0, 1, 25
"c:\Users\Lenovo\Desktop\aps\src\index.js", "JavaScript", 15, 0, 0, 0, 0, 0, 1, 16
"c:\Users\Lenovo\Desktop\aps\src\package.json", "JSON", 0, 58, 0, 0, 0, 0, 1, 59
"c:\Users\Lenovo\Desktop\aps\src\store\Schedule-slice.js", "JavaScript", 29, 0, 0, 0, 0, 0, 1, 30
"c:\Users\Lenovo\Desktop\aps\src\store\auth-slice.js", "JavaScript", 288, 0, 0, 0, 0, 0, 3, 291
"c:\Users\Lenovo\Desktop\aps\src\store\error-slice.js", "JavaScript", 24, 0, 0, 0, 0, 0, 0, 24
"c:\Users\Lenovo\Desktop\aps\src\store\fire.jsx", "JavaScript JSX", 0, 0, 225, 0, 0, 2, 6, 233
"c:\Users\Lenovo\Desktop\aps\src\store\getandset.js", "JavaScript", 699, 0, 0, 0, 0, 3, 39, 741
"c:\Users\Lenovo\Desktop\aps\src\store\index.js", "JavaScript", 18, 0, 0, 0, 0, 0, 1, 19
"c:\Users\Lenovo\Desktop\aps\src\store\message-slice.js", "JavaScript", 30, 0, 0, 0, 0, 0, 1, 31
"c:\Users\Lenovo\Desktop\aps\src\store\notify-slice.js", "JavaScript", 24, 0, 0, 0, 0, 0, 1, 25
"c:\Users\Lenovo\Desktop\aps\src\store\profile-slice.js", "JavaScript", 43, 0, 0, 0, 0, 0, 1, 44
"Total", "-", 19672, 58, 1892, 7318, 1, 256, 1220, 30417